,Season,GameNumber,VTeamCode,HTeamCode,HGF,VGF,GD,WinTeam
0,2010,20001,MTL,TOR,3,2,1,HOME
1,2010,20002,PHI,PIT,2,3,-1,AWAY
2,2010,20003,CAR,MIN,3,4,-1,AWAY
3,2010,20004,CHI,COL,4,3,1,HOME
4,2010,20005,CGY,EDM,4,0,4,HOME
5,2010,20006,SJ,CBJ,2,3,-1,AWAY
6,2010,20007,DAL,NJ,3,4,-1,AWAY
7,2010,20008,MIN,CAR,2,1,1,HOME
8,2010,20009,ANA,DET,4,0,4,HOME
9,2010,20010,BUF,OTT,1,2,-1,AWAY
10,2010,20011,WSH,ATL,4,2,2,HOME
11,2010,20012,PHX,BOS,2,5,-3,AWAY
12,2010,20013,NYR,BUF,3,6,-3,AWAY
13,2010,20014,OTT,TOR,5,1,4,HOME
14,2010,20015,DAL,NYI,4,5,-1,AWAY
15,2010,20016,MTL,PIT,2,3,-1,AWAY
16,2010,20017,NJ,WSH,7,2,5,HOME
17,2010,20018,ATL,TB,5,3,2,HOME
18,2010,20019,PHI,STL,2,1,1,HOME
19,2010,20020,ANA,NSH,4,1,3,HOME
20,2010,20021,DET,CHI,2,3,-1,AWAY
21,2010,20022,CBJ,SJ,2,3,-1,AWAY
22,2010,20023,LA,VAN,1,1,0,AWAY
23,2010,20024,BOS,PHX,0,3,-3,AWAY
24,2010,20025,LA,CGY,3,1,2,HOME
25,2010,20026,FLA,EDM,3,2,1,HOME
26,2010,20027,PIT,NJ,1,3,-2,AWAY
27,2010,20028,NYR,NYI,6,4,2,HOME
28,2010,20029,ANA,STL,5,1,4,HOME
29,2010,20030,CHI,BUF,3,4,-1,AWAY
30,2010,20031,COL,PHI,4,2,2,HOME
31,2010,20032,OTT,WSH,3,2,1,HOME
32,2010,20033,FLA,VAN,2,1,1,HOME
33,2010,20034,COL,DET,4,5,-1,AWAY
34,2010,20035,ATL,LA,3,1,2,HOME
35,2010,20036,NJ,BUF,0,1,-1,AWAY
36,2010,20037,NYI,WSH,2,1,1,HOME
37,2010,20038,TB,MTL,3,4,-1,AWAY
38,2010,20039,TOR,PIT,3,4,-1,AWAY
39,2010,20040,NSH,CHI,2,3,-1,AWAY
40,2010,20041,VAN,ANA,4,3,1,HOME
41,2010,20042,TB,PHI,2,3,-1,AWAY
42,2010,20043,CAR,OTT,3,2,1,HOME
43,2010,20044,STL,NSH,4,3,1,HOME
44,2010,20045,EDM,MIN,4,2,2,HOME
45,2010,20046,DET,DAL,4,1,3,HOME
46,2010,20047,FLA,CGY,0,3,-3,AWAY
47,2010,20048,COL,NJ,2,3,-1,AWAY
48,2010,20049,TOR,NYR,3,4,-1,AWAY
49,2010,20050,NYI,PIT,3,2,1,HOME
50,2010,20051,CHI,CBJ,2,5,-3,AWAY
51,2010,20052,MTL,BUF,1,2,-1,AWAY
52,2010,20053,ATL,ANA,4,5,-1,AWAY
53,2010,20054,VAN,LA,4,1,3,HOME
54,2010,20055,OTT,MTL,4,3,1,HOME
55,2010,20056,BOS,NJ,1,4,-3,AWAY
56,2010,20057,COL,NYI,5,2,3,HOME
57,2010,20058,PIT,PHI,1,5,-4,AWAY
58,2010,20059,TB,FLA,6,0,6,HOME
59,2010,20060,WSH,NSH,2,3,-1,AWAY
60,2010,20061,CBJ,MIN,2,3,-1,AWAY
61,2010,20062,STL,DAL,5,3,2,HOME
62,2010,20063,BUF,CHI,4,3,1,HOME
63,2010,20064,DET,PHX,1,2,-1,AWAY
64,2010,20065,EDM,CGY,5,3,2,HOME
65,2010,20066,ATL,SJ,2,4,-2,AWAY
66,2010,20067,PHX,ANA,3,2,1,HOME
67,2010,20068,CAR,VAN,5,1,4,HOME
68,2010,20069,NYI,TOR,1,2,-1,AWAY
69,2010,20070,COL,NYR,1,3,-2,AWAY
70,2010,20071,OTT,PIT,5,2,3,HOME
71,2010,20072,DAL,TB,5,4,1,HOME
72,2010,20073,STL,CHI,3,2,1,HOME
73,2010,20074,BOS,WSH,1,3,-2,AWAY
74,2010,20075,CGY,NSH,0,1,-1,AWAY
75,2010,20076,VAN,MIN,6,2,4,HOME
76,2010,20077,CAR,SJ,2,5,-3,AWAY
77,2010,20078,BUF,ATL,1,4,-3,AWAY
78,2010,20079,ANA,CBJ,3,1,2,HOME
79,2010,20080,VAN,CHI,4,3,1,HOME
80,2010,20081,CAR,LA,4,3,1,HOME
81,2010,20082,WSH,BOS,4,1,3,HOME
82,2010,20083,NYR,TOR,1,2,-1,AWAY
83,2010,20084,ANA,PHI,2,3,-1,AWAY
84,2010,20085,CGY,DET,4,2,2,HOME
85,2010,20086,NJ,MTL,0,3,-3,AWAY
86,2010,20087,NYI,TB,2,3,-1,AWAY
87,2010,20088,DAL,FLA,1,4,-3,AWAY
88,2010,20089,PIT,NSH,3,4,-1,AWAY
89,2010,20090,SJ,COL,2,4,-2,AWAY
90,2010,20091,MIN,EDM,2,4,-2,AWAY
91,2010,20092,LA,PHX,4,2,2,HOME
92,2010,20093,CGY,CBJ,2,6,-4,AWAY
93,2010,20094,OTT,BUF,2,4,-2,AWAY
94,2010,20095,TB,ATL,2,5,-3,AWAY
95,2010,20096,CHI,STL,4,2,2,HOME
96,2010,20097,MIN,VAN,5,1,4,HOME
97,2010,20098,NYR,BOS,2,3,-1,AWAY
98,2010,20099,MTL,OTT,0,3,-3,AWAY
99,2010,20100,BUF,NJ,1,6,-5,AWAY
100,2010,20101,TOR,PHI,5,2,3,HOME
101,2010,20102,ATL,WSH,4,3,1,HOME
102,2010,20103,NYI,FLA,4,3,1,HOME
103,2010,20104,ANA,DET,5,4,1,HOME
104,2010,20105,PIT,STL,1,0,1,HOME
105,2010,20106,NSH,DAL,0,1,-1,AWAY
106,2010,20107,CBJ,CHI,2,3,-1,AWAY
107,2010,20108,LA,COL,4,6,-2,AWAY
108,2010,20109,CAR,PHX,3,4,-1,AWAY
109,2010,20110,SJ,EDM,1,6,-5,AWAY
110,2010,20111,NSH,TB,3,4,-1,AWAY
111,2010,20112,NJ,NYR,3,1,2,HOME
112,2010,20113,SJ,CGY,4,0,4,HOME
113,2010,20114,PHI,CBJ,2,1,1,HOME
114,2010,20115,PHX,MTL,3,2,1,HOME
115,2010,20116,LA,MIN,4,5,-1,AWAY
116,2010,20117,FLA,TOR,3,1,2,HOME
117,2010,20118,BUF,PHI,6,3,3,HOME
118,2010,20119,PHX,OTT,5,2,3,HOME
119,2010,20120,EDM,CGY,5,4,1,HOME
120,2010,20121,ANA,DAL,2,5,-3,AWAY
121,2010,20122,COL,VAN,4,3,1,HOME
122,2010,20123,ATL,NYR,4,6,-2,AWAY
123,2010,20124,WSH,CAR,0,3,-3,AWAY
124,2010,20125,NYI,MTL,5,3,2,HOME
125,2010,20126,PIT,TB,5,3,2,HOME
126,2010,20127,LA,CHI,3,1,2,HOME
127,2010,20128,NJ,SJ,5,2,3,HOME
128,2010,20129,TOR,BOS,2,0,2,HOME
129,2010,20130,PHX,DET,2,4,-2,AWAY
130,2010,20131,EDM,CBJ,4,2,2,HOME
131,2010,20132,FLA,OTT,5,3,2,HOME
132,2010,20133,STL,NSH,0,3,-3,AWAY
133,2010,20134,WSH,MIN,2,1,1,HOME
134,2010,20135,LA,DAL,2,5,-3,AWAY
135,2010,20136,COL,CGY,5,6,-1,AWAY
136,2010,20137,MTL,NYI,1,3,-2,AWAY
137,2010,20138,CAR,NYR,3,4,-1,AWAY
138,2010,20139,PHI,PIT,2,3,-1,AWAY
139,2010,20140,BUF,ATL,4,3,1,HOME
140,2010,20141,EDM,CHI,4,7,-3,AWAY
141,2010,20142,NJ,ANA,1,2,-1,AWAY
142,2010,20143,NYR,TOR,0,2,-2,AWAY
143,2010,20144,FLA,MTL,1,3,-2,AWAY
144,2010,20145,BOS,OTT,0,4,-4,AWAY
145,2010,20146,NYI,PHI,6,1,5,HOME
146,2010,20147,PIT,CAR,0,3,-3,AWAY
147,2010,20148,NSH,DET,5,2,3,HOME
148,2010,20149,ATL,STL,5,3,2,HOME
149,2010,20150,CHI,MIN,1,3,-2,AWAY
150,2010,20151,BUF,DAL,4,0,4,HOME
151,2010,20152,CBJ,COL,5,1,4,HOME
152,2010,20153,TB,PHX,0,3,-3,AWAY
153,2010,20154,WSH,CGY,2,7,-5,AWAY
154,2010,20155,NJ,LA,3,1,2,HOME
155,2010,20156,ANA,SJ,5,2,3,HOME
156,2010,20157,CHI,NYR,3,2,1,HOME
157,2010,20158,CAR,PHI,3,2,1,HOME
158,2010,20159,NJ,VAN,3,0,3,HOME
159,2010,20160,OTT,TOR,2,3,-1,AWAY
160,2010,20161,MTL,CBJ,3,0,3,HOME
161,2010,20162,SJ,MIN,1,0,1,HOME
162,2010,20163,VAN,EDM,3,4,-1,AWAY
163,2010,20164,BOS,BUF,2,5,-3,AWAY
164,2010,20165,TOR,WSH,6,4,2,HOME
165,2010,20166,NYI,CAR,7,2,5,HOME
166,2010,20167,ATL,FLA,3,4,-1,AWAY
167,2010,20168,NJ,CHI,3,5,-2,AWAY
168,2010,20169,PIT,DAL,5,2,3,HOME
169,2010,20170,DET,CGY,1,2,-1,AWAY
170,2010,20171,NSH,PHX,4,3,1,HOME
171,2010,20172,TB,ANA,3,2,1,HOME
172,2010,20173,NYR,PHI,4,1,3,HOME
173,2010,20174,CBJ,ATL,0,3,-3,AWAY
174,2010,20175,NYI,OTT,4,1,3,HOME
175,2010,20176,SJ,STL,2,0,2,HOME
176,2010,20177,VAN,COL,1,3,-2,AWAY
177,2010,20178,TB,LA,1,0,1,HOME
178,2010,20179,NYR,NJ,0,3,-3,AWAY
179,2010,20180,BOS,WSH,5,3,2,HOME
180,2010,20181,MTL,BUF,2,3,-1,AWAY
181,2010,20182,CAR,FLA,7,4,3,HOME
182,2010,20183,CGY,MIN,2,1,1,HOME
183,2010,20184,PHX,DAL,6,3,3,HOME
184,2010,20185,DET,EDM,1,3,-2,AWAY
185,2010,20186,PIT,ANA,3,2,1,HOME
186,2010,20187,NSH,LA,4,1,3,HOME
187,2010,20188,STL,BOS,2,3,-1,AWAY
188,2010,20189,BUF,TOR,3,4,-1,AWAY
189,2010,20190,OTT,MTL,2,3,-1,AWAY
190,2010,20191,PHI,NYI,1,2,-1,AWAY
191,2010,20192,FLA,CAR,3,2,1,HOME
192,2010,20193,CHI,ATL,5,6,-1,AWAY
193,2010,20194,MIN,CBJ,2,3,-1,AWAY
194,2010,20195,DAL,COL,5,0,5,HOME
195,2010,20196,PIT,PHX,3,4,-1,AWAY
196,2010,20197,DET,VAN,6,4,2,HOME
197,2010,20198,TB,SJ,5,2,3,HOME
198,2010,20199,PHI,WSH,3,2,1,HOME
199,2010,20200,STL,NYR,0,2,-2,AWAY
200,2010,20201,EDM,CHI,1,2,-1,AWAY
201,2010,20202,NSH,ANA,5,4,1,HOME
202,2010,20203,PHX,DET,3,2,1,HOME
203,2010,20204,WSH,NYR,3,5,-2,AWAY
204,2010,20205,EDM,CAR,7,1,6,HOME
205,2010,20206,VAN,MTL,2,0,2,HOME
206,2010,20207,ATL,OTT,5,2,3,HOME
207,2010,20208,TOR,TB,4,0,4,HOME
208,2010,20209,CGY,COL,2,4,-2,AWAY
209,2010,20210,ANA,SJ,2,3,-1,AWAY
210,2010,20211,BUF,NJ,5,6,-1,AWAY
211,2010,20212,BOS,PIT,4,7,-3,AWAY
212,2010,20213,STL,CBJ,8,1,7,HOME
213,2010,20214,TOR,FLA,4,1,3,HOME
214,2010,20215,PHX,CHI,1,2,-1,AWAY
215,2010,20216,NYI,ANA,1,0,1,HOME
216,2010,20217,MTL,BOS,1,3,-2,AWAY
217,2010,20218,BUF,NYR,3,2,1,HOME
218,2010,20219,TB,WSH,6,3,3,HOME
219,2010,20220,PHI,CAR,1,8,-7,AWAY
220,2010,20221,MIN,ATL,5,1,4,HOME
221,2010,20222,EDM,DET,6,2,4,HOME
222,2010,20223,VAN,OTT,2,6,-4,AWAY
223,2010,20224,NSH,STL,3,4,-1,AWAY
224,2010,20225,DAL,LA,3,1,2,HOME
225,2010,20226,NYI,SJ,3,1,2,HOME
226,2010,20227,EDM,NJ,4,3,1,HOME
227,2010,20228,TB,PIT,5,1,4,HOME
228,2010,20229,COL,CBJ,1,5,-4,AWAY
229,2010,20230,MIN,FLA,2,1,1,HOME
230,2010,20231,CGY,PHX,5,4,1,HOME
231,2010,20232,DAL,ANA,4,2,2,HOME
232,2010,20233,OTT,BOS,0,2,-2,AWAY
233,2010,20234,WSH,BUF,3,2,1,HOME
234,2010,20235,VAN,TOR,3,5,-2,AWAY
235,2010,20236,CAR,MTL,7,2,5,HOME
236,2010,20237,FLA,PHI,5,2,3,HOME
237,2010,20238,PIT,ATL,2,4,-2,AWAY
238,2010,20239,COL,DET,3,1,2,HOME
239,2010,20240,CHI,NSH,4,3,1,HOME
240,2010,20241,STL,PHX,5,3,2,HOME
241,2010,20242,CGY,SJ,4,3,1,HOME
242,2010,20243,NYI,LA,5,1,4,HOME
243,2010,20244,EDM,NYR,8,2,6,HOME
244,2010,20245,ATL,WSH,6,4,2,HOME
245,2010,20246,MIN,TB,1,4,-3,AWAY
246,2010,20247,ANA,CHI,3,2,1,HOME
247,2010,20248,NJ,BOS,3,0,3,HOME
248,2010,20249,VAN,BUF,4,3,1,HOME
249,2010,20250,OTT,PHI,5,1,4,HOME
250,2010,20251,NYR,PIT,2,3,-1,AWAY
251,2010,20252,STL,COL,6,3,3,HOME
252,2010,20253,LA,SJ,6,3,3,HOME
253,2010,20254,NSH,TOR,5,4,1,HOME
254,2010,20255,PHI,MTL,3,0,3,HOME
255,2010,20256,ANA,DAL,2,1,1,HOME
256,2010,20257,TB,NYI,2,4,-2,AWAY
257,2010,20258,BOS,NYR,2,3,-1,AWAY
258,2010,20259,VAN,PIT,3,1,2,HOME
259,2010,20260,BUF,WSH,4,2,2,HOME
260,2010,20261,OTT,CAR,7,1,6,HOME
261,2010,20262,FLA,ATL,1,2,-1,AWAY
262,2010,20263,STL,DET,7,3,4,HOME
263,2010,20264,ANA,MIN,2,1,1,HOME
264,2010,20265,SJ,COL,4,3,1,HOME
265,2010,20266,PHX,CGY,1,3,-2,AWAY
266,2010,20267,CHI,EDM,0,5,-5,AWAY
267,2010,20268,CBJ,LA,3,5,-2,AWAY
268,2010,20269,FLA,BOS,4,0,4,HOME
269,2010,20270,NJ,TOR,3,1,2,HOME
270,2010,20271,TB,PHI,7,8,-1,AWAY
271,2010,20272,NSH,MTL,0,3,-3,AWAY
272,2010,20273,SJ,DAL,5,4,1,HOME
273,2010,20274,CAR,PIT,6,4,2,HOME
274,2010,20275,MIN,DET,3,4,-1,AWAY
275,2010,20276,LA,BUF,4,2,2,HOME
276,2010,20277,WSH,ATL,5,0,5,HOME
277,2010,20278,OTT,STL,5,2,3,HOME
278,2010,20279,NYR,COL,5,1,4,HOME
279,2010,20280,CHI,CGY,7,2,5,HOME
280,2010,20281,PHX,EDM,5,6,-1,AWAY
281,2010,20282,CBJ,ANA,3,4,-1,AWAY
282,2010,20283,LA,BOS,3,4,-1,AWAY
283,2010,20284,TB,BUF,1,2,-1,AWAY
284,2010,20285,TOR,MTL,2,0,2,HOME
285,2010,20286,FLA,NYI,1,4,-3,AWAY
286,2010,20287,PHI,WSH,4,5,-1,AWAY
287,2010,20288,NSH,CAR,2,3,-1,AWAY
288,2010,20289,NJ,STL,3,2,1,HOME
289,2010,20290,NYR,MIN,2,5,-3,AWAY
290,2010,20291,COL,DAL,4,5,-1,AWAY
291,2010,20292,CHI,VAN,1,7,-6,AWAY
292,2010,20293,CBJ,SJ,0,3,-3,AWAY
293,2010,20294,NYI,ATL,2,1,1,HOME
294,2010,20295,CGY,DET,5,4,1,HOME
295,2010,20296,EDM,ANA,2,4,-2,AWAY
296,2010,20297,PHX,VAN,2,3,-1,AWAY
297,2010,20298,DAL,TOR,4,1,3,HOME
298,2010,20299,WSH,NJ,5,0,5,HOME
299,2010,20300,CGY,NYR,2,1,1,HOME
300,2010,20301,MTL,PHI,3,2,1,HOME
301,2010,20302,NSH,CBJ,2,0,2,HOME
302,2010,20303,LA,OTT,3,2,1,HOME
303,2010,20304,BOS,TB,3,1,2,HOME
304,2010,20305,PIT,FLA,2,3,-1,AWAY
305,2010,20306,EDM,PHX,5,0,5,HOME
306,2010,20307,PIT,BUF,0,1,-1,AWAY
307,2010,20308,CBJ,NYI,3,4,-1,AWAY
308,2010,20309,WSH,CAR,2,3,-1,AWAY
309,2010,20310,DET,ATL,5,1,4,HOME
310,2010,20311,LA,MTL,4,1,3,HOME
311,2010,20312,DAL,OTT,1,2,-1,AWAY
312,2010,20313,CGY,NJ,2,1,1,HOME
313,2010,20314,NYR,TB,5,3,2,HOME
314,2010,20315,BOS,FLA,1,3,-2,AWAY
315,2010,20316,STL,NSH,1,2,-1,AWAY
316,2010,20317,PHI,MIN,1,6,-5,AWAY
317,2010,20318,COL,VAN,4,2,2,HOME
318,2010,20319,CHI,SJ,5,2,3,HOME
319,2010,20320,COL,EDM,3,2,1,HOME
320,2010,20321,CAR,BOS,0,3,-3,AWAY
321,2010,20322,NJ,NYI,2,0,2,HOME
322,2010,20323,CGY,PHI,3,4,-1,AWAY
323,2010,20324,OTT,PIT,2,1,1,HOME
324,2010,20325,NSH,MIN,5,2,3,HOME
325,2010,20326,CHI,ANA,1,4,-3,AWAY
326,2010,20327,TB,WSH,6,0,6,HOME
327,2010,20328,DET,CBJ,1,2,-1,AWAY
328,2010,20329,TOR,BUF,3,1,2,HOME
329,2010,20330,MTL,ATL,3,0,3,HOME
330,2010,20331,NYR,FLA,0,3,-3,AWAY
331,2010,20332,STL,DAL,3,2,1,HOME
332,2010,20333,SJ,VAN,6,1,5,HOME
333,2010,20334,PHI,NJ,3,2,1,HOME
334,2010,20335,CGY,PIT,4,1,3,HOME
335,2010,20336,BUF,MTL,3,1,2,HOME
336,2010,20337,TOR,OTT,3,0,3,HOME
337,2010,20338,FLA,TB,3,4,-1,AWAY
338,2010,20339,DAL,STL,1,2,-1,AWAY
339,2010,20340,NYR,NSH,1,2,-1,AWAY
340,2010,20341,ANA,PHX,4,6,-2,AWAY
341,2010,20342,MIN,COL,7,4,3,HOME
342,2010,20343,SJ,EDM,3,4,-1,AWAY
343,2010,20344,CHI,LA,1,2,-1,AWAY
344,2010,20345,CAR,WSH,3,2,1,HOME
345,2010,20346,BOS,ATL,4,1,3,HOME
346,2010,20347,CBJ,DET,4,2,2,HOME
347,2010,20348,PIT,NYR,1,3,-2,AWAY
348,2010,20349,DAL,CAR,1,4,-3,AWAY
349,2010,20350,EDM,OTT,1,4,-3,AWAY
350,2010,20351,MIN,CGY,3,0,3,HOME
351,2010,20352,LA,ANA,2,0,2,HOME
352,2010,20353,TB,TOR,3,4,-1,AWAY
353,2010,20354,PHX,NSH,3,0,3,HOME
354,2010,20355,STL,CHI,7,5,2,HOME
355,2010,20356,ATL,COL,2,3,-1,AWAY
356,2010,20357,DET,SJ,3,5,-2,AWAY
357,2010,20358,EDM,MTL,3,4,-1,AWAY
358,2010,20359,BOS,PHI,0,3,-3,AWAY
359,2010,20360,NSH,CBJ,3,4,-1,AWAY
360,2010,20361,WSH,STL,1,4,-3,AWAY
361,2010,20362,PHX,MIN,2,4,-2,AWAY
362,2010,20363,VAN,CGY,2,7,-5,AWAY
363,2010,20364,FLA,ANA,5,3,2,HOME
364,2010,20365,TB,BOS,8,1,7,HOME
365,2010,20366,EDM,TOR,0,5,-5,AWAY
366,2010,20367,MTL,NJ,1,5,-4,AWAY
367,2010,20368,NYR,NYI,5,6,-1,AWAY
368,2010,20369,ATL,PIT,3,2,1,HOME
369,2010,20370,SJ,OTT,0,4,-4,AWAY
370,2010,20371,WSH,DAL,2,1,1,HOME
371,2010,20372,FLA,LA,3,2,1,HOME
372,2010,20373,NYI,NYR,2,0,2,HOME
373,2010,20374,COL,CAR,2,1,1,HOME
374,2010,20375,CBJ,BUF,5,0,5,HOME
375,2010,20376,CGY,MIN,3,4,-1,AWAY
376,2010,20377,VAN,CHI,0,3,-3,AWAY
377,2010,20378,DET,ANA,0,4,-4,AWAY
378,2010,20379,NJ,PHI,5,3,2,HOME
379,2010,20380,SJ,MTL,3,1,2,HOME
380,2010,20381,BOS,TOR,4,3,1,HOME
381,2010,20382,BUF,OTT,0,1,-1,AWAY
382,2010,20383,ATL,WSH,1,3,-2,AWAY
383,2010,20384,PIT,CBJ,2,7,-5,AWAY
384,2010,20385,COL,TB,6,5,1,HOME
385,2010,20386,CAR,NSH,5,2,3,HOME
386,2010,20387,MIN,DAL,4,3,1,HOME
387,2010,20388,FLA,PHX,3,4,-1,AWAY
388,2010,20389,STL,EDM,2,1,1,HOME
389,2010,20390,DET,LA,3,2,1,HOME
390,2010,20391,PHI,NYI,2,3,-1,AWAY
391,2010,20392,OTT,NYR,1,3,-2,AWAY
392,2010,20393,CGY,CHI,4,2,2,HOME
393,2010,20394,PHX,ANA,0,3,-3,AWAY
394,2010,20395,STL,VAN,2,3,-1,AWAY
395,2010,20396,NJ,PIT,2,1,1,HOME
396,2010,20397,TOR,WSH,4,5,-1,AWAY
397,2010,20398,NSH,ATL,3,2,1,HOME
398,2010,20399,SJ,DET,2,5,-3,AWAY
399,2010,20400,DAL,CBJ,4,3,1,HOME
400,2010,20401,BUF,BOS,3,2,1,HOME
401,2010,20402,OTT,MTL,4,1,3,HOME
402,2010,20403,COL,FLA,4,3,1,HOME
403,2010,20404,TB,CGY,4,2,2,HOME
404,2010,20405,ANA,EDM,3,4,-1,AWAY
405,2010,20406,SJ,PHI,4,6,-2,AWAY
406,2010,20407,TOR,PIT,5,2,3,HOME
407,2010,20408,NSH,DET,2,3,-1,AWAY
408,2010,20409,DAL,CHI,5,3,2,HOME
409,2010,20410,ANA,VAN,5,4,1,HOME
410,2010,20411,NYI,BOS,5,2,3,HOME
411,2010,20412,SJ,BUF,6,3,3,HOME
412,2010,20413,PHI,TOR,1,4,-3,AWAY
413,2010,20414,FLA,WSH,0,3,-3,AWAY
414,2010,20415,NYR,OTT,3,5,-2,AWAY
415,2010,20416,CBJ,STL,4,1,3,HOME
416,2010,20417,MIN,PHX,2,3,-1,AWAY
417,2010,20418,CGY,LA,2,1,1,HOME
418,2010,20419,MTL,DET,4,2,2,HOME
419,2010,20420,NJ,OTT,3,2,1,HOME
420,2010,20421,COL,ATL,2,4,-2,AWAY
421,2010,20422,CAR,DAL,2,1,1,HOME
422,2010,20423,TB,EDM,5,3,2,HOME
423,2010,20424,CGY,ANA,4,3,1,HOME
424,2010,20425,PHI,BOS,1,2,-1,AWAY
425,2010,20426,PIT,BUF,2,5,-3,AWAY
426,2010,20427,MTL,TOR,3,1,2,HOME
427,2010,20428,DET,NJ,1,4,-3,AWAY
428,2010,20429,ATL,NYI,4,5,-1,AWAY
429,2010,20430,COL,WSH,2,3,-1,AWAY
430,2010,20431,NYR,CBJ,3,1,2,HOME
431,2010,20432,CAR,STL,1,2,-1,AWAY
432,2010,20433,FLA,NSH,3,0,3,HOME
433,2010,20434,DAL,PHX,5,2,3,HOME
434,2010,20435,TB,VAN,4,5,-1,AWAY
435,2010,20436,MIN,LA,2,3,-1,AWAY
436,2010,20437,CHI,SJ,2,1,1,HOME
437,2010,20438,WSH,NYR,7,0,7,HOME
438,2010,20439,VAN,EDM,1,2,-1,AWAY
439,2010,20440,MIN,ANA,6,2,4,HOME
440,2010,20441,LA,DET,0,5,-5,AWAY
441,2010,20442,ATL,OTT,3,4,-1,AWAY
442,2010,20443,NYI,NSH,5,0,5,HOME
443,2010,20444,CHI,COL,7,5,2,HOME
444,2010,20445,CBJ,CGY,3,2,1,HOME
445,2010,20446,DAL,SJ,3,4,-1,AWAY
446,2010,20447,PIT,PHI,3,2,1,HOME
447,2010,20448,TOR,EDM,1,4,-3,AWAY
448,2010,20449,BOS,BUF,3,2,1,HOME
449,2010,20450,PHX,NJ,3,0,3,HOME
450,2010,20451,NYR,PIT,1,4,-3,AWAY
451,2010,20452,ANA,WSH,1,2,-1,AWAY
452,2010,20453,STL,DET,5,2,3,HOME
453,2010,20454,PHI,MTL,3,5,-2,AWAY
454,2010,20455,ATL,TB,2,1,1,HOME
455,2010,20456,CAR,FLA,3,4,-1,AWAY
456,2010,20457,SJ,NSH,3,2,1,HOME
457,2010,20458,COL,CHI,3,4,-1,AWAY
458,2010,20459,CBJ,VAN,3,2,1,HOME
459,2010,20460,ANA,NYI,3,2,1,HOME
460,2010,20461,PHX,NYR,4,3,1,HOME
461,2010,20462,CAR,ATL,3,4,-1,AWAY
462,2010,20463,BOS,MTL,4,3,1,HOME
463,2010,20464,LA,STL,6,4,2,HOME
464,2010,20465,OTT,MIN,1,3,-2,AWAY
465,2010,20466,SJ,DAL,3,4,-1,AWAY
466,2010,20467,TOR,CGY,5,2,3,HOME
467,2010,20468,CBJ,EDM,6,3,3,HOME
468,2010,20469,NSH,NJ,1,3,-2,AWAY
469,2010,20470,BUF,FLA,6,2,4,HOME
470,2010,20471,DET,CHI,4,1,3,HOME
471,2010,20472,OTT,COL,6,5,1,HOME
472,2010,20473,NYR,PHI,4,1,3,HOME
473,2010,20474,WSH,BOS,3,2,1,HOME
474,2010,20475,PHX,NYI,4,6,-2,AWAY
475,2010,20476,ANA,CAR,4,2,2,HOME
476,2010,20477,NJ,ATL,7,1,6,HOME
477,2010,20478,DAL,CBJ,1,2,-1,AWAY
478,2010,20479,BUF,TB,3,1,2,HOME
479,2010,20480,SJ,STL,1,4,-3,AWAY
480,2010,20481,LA,NSH,1,6,-5,AWAY
481,2010,20482,MIN,CGY,1,3,-2,AWAY
482,2010,20483,TOR,VAN,4,1,3,HOME
483,2010,20484,WSH,OTT,2,3,-1,AWAY
484,2010,20485,DAL,DET,3,4,-1,AWAY
485,2010,20486,LA,CHI,3,2,1,HOME
486,2010,20487,MTL,COL,3,2,1,HOME
487,2010,20488,ANA,BOS,0,3,-3,AWAY
488,2010,20489,ATL,TOR,3,6,-3,AWAY
489,2010,20490,FLA,PHI,0,5,-5,AWAY
490,2010,20491,PHX,PIT,6,1,5,HOME
491,2010,20492,CAR,TB,5,1,4,HOME
492,2010,20493,VAN,STL,1,3,-2,AWAY
493,2010,20494,CGY,MIN,4,1,3,HOME
494,2010,20495,ANA,BUF,5,2,3,HOME
495,2010,20496,NJ,WSH,5,1,4,HOME
496,2010,20497,STL,ATL,2,4,-2,AWAY
497,2010,20498,CGY,CBJ,3,1,2,HOME
498,2010,20499,MTL,DAL,5,2,3,HOME
499,2010,20500,LA,COL,0,5,-5,AWAY
500,2010,20501,EDM,SJ,2,1,1,HOME
501,2010,20502,TB,NYI,2,1,1,HOME
502,2010,20503,FLA,PIT,5,2,3,HOME
503,2010,20504,VAN,DET,5,4,1,HOME
504,2010,20505,NSH,CHI,4,1,3,HOME
505,2010,20506,ATL,BOS,4,1,3,HOME
506,2010,20507,FLA,BUF,3,4,-1,AWAY
507,2010,20508,NYI,NJ,1,5,-4,AWAY
508,2010,20509,TB,NYR,5,6,-1,AWAY
509,2010,20510,PIT,WSH,3,4,-1,AWAY
510,2010,20511,MTL,CAR,2,3,-1,AWAY
511,2010,20512,VAN,CBJ,3,7,-4,AWAY
512,2010,20513,DET,STL,4,3,1,HOME
513,2010,20514,OTT,NSH,1,2,-1,AWAY
514,2010,20515,CGY,DAL,2,3,-1,AWAY
515,2010,20516,MIN,COL,1,3,-2,AWAY
516,2010,20517,EDM,LA,4,3,1,HOME
517,2010,20518,PHX,SJ,4,1,3,HOME
518,2010,20519,PIT,OTT,3,1,2,HOME
519,2010,20520,TOR,NJ,1,4,-3,AWAY
520,2010,20521,MTL,NYI,4,1,3,HOME
521,2010,20522,WSH,CAR,2,3,-1,AWAY
522,2010,20523,TB,ATL,2,3,-1,AWAY
523,2010,20524,CBJ,CHI,4,1,3,HOME
524,2010,20525,NSH,STL,2,0,2,HOME
525,2010,20526,DET,MIN,1,4,-3,AWAY
526,2010,20527,PHX,DAL,0,1,-1,AWAY
527,2010,20528,EDM,VAN,3,2,1,HOME
528,2010,20529,ANA,LA,4,1,3,HOME
529,2010,20530,NYI,NYR,7,2,5,HOME
530,2010,20531,MIN,CBJ,6,4,2,HOME
531,2010,20532,BOS,FLA,2,3,-1,AWAY
532,2010,20533,DET,COL,3,4,-1,AWAY
533,2010,20534,BUF,CGY,5,2,3,HOME
534,2010,20535,LA,SJ,0,4,-4,AWAY
535,2010,20536,CAR,TOR,3,4,-1,AWAY
536,2010,20537,ATL,PIT,6,3,3,HOME
537,2010,20538,MTL,WSH,3,0,3,HOME
538,2010,20539,BOS,TB,3,4,-1,AWAY
539,2010,20540,CHI,STL,3,1,2,HOME
540,2010,20541,DAL,NSH,2,4,-2,AWAY
541,2010,20542,BUF,EDM,2,4,-2,AWAY
542,2010,20543,ANA,PHX,1,3,-2,AWAY
543,2010,20544,PHI,VAN,6,2,4,HOME
544,2010,20545,NYR,NJ,1,3,-2,AWAY
545,2010,20546,PIT,NYI,4,3,1,HOME
546,2010,20547,CAR,OTT,0,4,-4,AWAY
547,2010,20548,SJ,MIN,5,3,2,HOME
548,2010,20549,DET,DAL,3,7,-4,AWAY
549,2010,20550,LA,PHX,6,3,3,HOME
550,2010,20551,CBJ,TOR,2,3,-1,AWAY
551,2010,20552,BOS,ATL,4,2,2,HOME
552,2010,20553,MTL,TB,4,1,3,HOME
553,2010,20554,SJ,CHI,3,5,-2,AWAY
554,2010,20555,COL,EDM,3,4,-1,AWAY
555,2010,20556,PHI,LA,4,7,-3,AWAY
556,2010,20557,ATL,NJ,3,1,2,HOME
557,2010,20558,MTL,FLA,2,3,-1,AWAY
558,2010,20559,NSH,MIN,1,4,-3,AWAY
559,2010,20560,NYI,DET,3,4,-1,AWAY
560,2010,20561,OTT,CBJ,4,3,1,HOME
561,2010,20562,PHX,STL,4,3,1,HOME
562,2010,20563,PHI,ANA,5,2,3,HOME
563,2010,20564,VAN,DAL,1,4,-3,AWAY
564,2010,20565,COL,CGY,3,2,1,HOME
565,2010,20566,WSH,PIT,1,3,-2,AWAY
566,2010,20567,BOS,BUF,9,8,1,HOME
567,2010,20568,TOR,OTT,1,5,-4,AWAY
568,2010,20569,NJ,CAR,6,3,3,HOME
569,2010,20570,NYR,TB,2,1,1,HOME
570,2010,20571,SJ,LA,0,1,-1,AWAY
571,2010,20572,CGY,EDM,1,2,-1,AWAY
572,2010,20573,ATL,MTL,3,4,-1,AWAY
573,2010,20574,NYR,FLA,3,0,3,HOME
574,2010,20575,PHI,DET,2,3,-1,AWAY
575,2010,20576,DAL,STL,2,4,-2,AWAY
576,2010,20577,CBJ,NSH,4,1,3,HOME
577,2010,20578,PHX,MIN,6,5,1,HOME
578,2010,20579,VAN,COL,1,2,-1,AWAY
579,2010,20580,CHI,ANA,2,1,1,HOME
580,2010,20581,BOS,TOR,1,2,-1,AWAY
581,2010,20582,FLA,CAR,3,4,-1,AWAY
582,2010,20583,NYI,CGY,2,5,-3,AWAY
583,2010,20584,CHI,LA,3,4,-1,AWAY
584,2010,20585,VAN,SJ,3,4,-1,AWAY
585,2010,20586,MIN,NJ,1,2,-1,AWAY
586,2010,20587,TB,WSH,0,1,-1,AWAY
587,2010,20588,BUF,COL,4,3,1,HOME
588,2010,20589,DET,EDM,3,5,-2,AWAY
589,2010,20590,CBJ,PHX,4,2,2,HOME
590,2010,20591,CAR,NYR,2,1,1,HOME
591,2010,20592,TB,PIT,8,1,7,HOME
592,2010,20593,ATL,FLA,2,3,-1,AWAY
593,2010,20594,DAL,CHI,2,4,-2,AWAY
594,2010,20595,CGY,VAN,3,1,2,HOME
595,2010,20596,NSH,ANA,1,4,-3,AWAY
596,2010,20597,MIN,BOS,1,3,-2,AWAY
597,2010,20598,STL,TOR,8,7,1,HOME
598,2010,20599,PHI,NJ,2,4,-2,AWAY
599,2010,20600,PIT,MTL,2,1,1,HOME
600,2010,20601,PHX,COL,0,2,-2,AWAY
601,2010,20602,NYI,EDM,2,1,1,HOME
602,2010,20603,NSH,LA,2,5,-3,AWAY
603,2010,20604,BUF,SJ,0,3,-3,AWAY
604,2010,20605,TOR,ATL,3,9,-6,AWAY
605,2010,20606,CAR,FLA,3,5,-2,AWAY
606,2010,20607,OTT,CHI,4,2,2,HOME
607,2010,20608,NYR,DAL,2,3,-1,AWAY
608,2010,20609,DET,CGY,4,5,-1,AWAY
609,2010,20610,EDM,VAN,6,1,5,HOME
610,2010,20611,CBJ,ANA,6,0,6,HOME
611,2010,20612,NJ,PHI,2,1,1,HOME
612,2010,20613,NYI,COL,3,4,-1,AWAY
613,2010,20614,BOS,MTL,3,2,1,HOME
614,2010,20615,TB,OTT,1,2,-1,AWAY
615,2010,20616,MIN,PIT,0,4,-4,AWAY
616,2010,20617,FLA,WSH,3,2,1,HOME
617,2010,20618,NYR,STL,1,2,-1,AWAY
618,2010,20619,BUF,PHX,1,2,-1,AWAY
619,2010,20620,NSH,SJ,1,2,-1,AWAY
620,2010,20621,DET,VAN,1,2,-1,AWAY
621,2010,20622,CBJ,LA,6,4,2,HOME
622,2010,20623,ATL,CAR,4,3,1,HOME
623,2010,20624,TB,NJ,6,3,3,HOME
624,2010,20625,DAL,MIN,0,4,-4,AWAY
625,2010,20626,NYI,CHI,5,0,5,HOME
626,2010,20627,SJ,ANA,1,0,1,HOME
627,2010,20628,BOS,PIT,2,4,-2,AWAY
628,2010,20629,PHX,STL,3,4,-1,AWAY
629,2010,20630,DET,COL,5,4,1,HOME
630,2010,20631,TOR,LA,2,3,-1,AWAY
631,2010,20632,OTT,BOS,6,0,6,HOME
632,2010,20633,PHI,BUF,2,5,-3,AWAY
633,2010,20634,VAN,NYI,4,5,-1,AWAY
634,2010,20635,MTL,NYR,1,2,-1,AWAY
635,2010,20636,CGY,CAR,6,5,1,HOME
636,2010,20637,PHX,CBJ,3,4,-1,AWAY
637,2010,20638,WSH,FLA,4,3,1,HOME
638,2010,20639,MIN,NSH,5,1,4,HOME
639,2010,20640,EDM,DAL,3,2,1,HOME
640,2010,20641,TOR,SJ,2,4,-2,AWAY
641,2010,20642,PIT,MTL,2,5,-3,AWAY
642,2010,20643,WSH,TB,3,0,3,HOME
643,2010,20644,COL,CHI,4,0,4,HOME
644,2010,20645,STL,ANA,7,4,3,HOME
645,2010,20646,PHI,BOS,7,5,2,HOME
646,2010,20647,CAR,BUF,3,2,1,HOME
647,2010,20648,OTT,NYI,4,6,-2,AWAY
648,2010,20649,VAN,NYR,1,0,1,HOME
649,2010,20650,NSH,FLA,3,2,1,HOME
650,2010,20651,TOR,PHX,5,1,4,HOME
651,2010,20652,STL,LA,1,3,-2,AWAY
652,2010,20653,EDM,SJ,2,5,-3,AWAY
653,2010,20654,VAN,WSH,2,4,-2,AWAY
654,2010,20655,DET,CBJ,3,2,1,HOME
655,2010,20656,CGY,OTT,2,3,-1,AWAY
656,2010,20657,PHI,ATL,2,5,-3,AWAY
657,2010,20658,NJ,TB,2,5,-3,AWAY
658,2010,20659,COL,MIN,1,4,-3,AWAY
659,2010,20660,PIT,BOS,2,3,-1,AWAY
660,2010,20661,CGY,TOR,3,4,-1,AWAY
661,2010,20662,NYR,MTL,3,2,1,HOME
662,2010,20663,BUF,NYI,5,3,2,HOME
663,2010,20664,TB,CAR,6,4,2,HOME
664,2010,20665,NJ,FLA,3,2,1,HOME
665,2010,20666,CBJ,DET,6,5,1,HOME
666,2010,20667,CHI,NSH,3,2,1,HOME
667,2010,20668,ATL,DAL,6,1,5,HOME
668,2010,20669,ANA,PHX,6,2,4,HOME
669,2010,20670,EDM,LA,5,2,3,HOME
670,2010,20671,STL,SJ,4,2,2,HOME
671,2010,20672,OTT,WSH,3,1,2,HOME
672,2010,20673,VAN,MIN,4,0,4,HOME
673,2010,20674,PHI,NYR,2,3,-1,AWAY
674,2010,20675,NSH,CHI,6,3,3,HOME
675,2010,20676,EDM,ANA,3,2,1,HOME
676,2010,20677,CAR,BOS,7,0,7,HOME
677,2010,20678,NJ,NYI,2,5,-3,AWAY
678,2010,20679,SJ,PHX,2,4,-2,AWAY
679,2010,20680,CGY,MTL,5,4,1,HOME
680,2010,20681,ATL,FLA,3,4,-1,AWAY
681,2010,20682,LA,DAL,2,1,1,HOME
682,2010,20683,MTL,BUF,2,1,1,HOME
683,2010,20684,WSH,PHI,3,2,1,HOME
684,2010,20685,DET,PIT,4,1,3,HOME
685,2010,20686,BOS,CAR,2,3,-1,AWAY
686,2010,20687,ANA,OTT,1,2,-1,AWAY
687,2010,20688,CBJ,TB,3,2,1,HOME
688,2010,20689,LA,STL,2,1,1,HOME
689,2010,20690,VAN,COL,4,3,1,HOME
690,2010,20691,MIN,EDM,1,4,-3,AWAY
691,2010,20692,NSH,PHX,2,5,-3,AWAY
692,2010,20693,TOR,NYR,7,0,7,HOME
693,2010,20694,CBJ,FLA,2,3,-1,AWAY
694,2010,20695,MIN,CGY,0,6,-6,AWAY
695,2010,20696,BUF,BOS,2,4,-2,AWAY
696,2010,20697,ANA,TOR,5,2,3,HOME
697,2010,20698,PIT,NJ,2,0,2,HOME
698,2010,20699,WSH,NYI,1,2,-1,AWAY
699,2010,20700,OTT,PHI,6,2,4,HOME
700,2010,20701,NYR,CAR,4,1,3,HOME
701,2010,20702,TB,ATL,3,4,-1,AWAY
702,2010,20703,DET,STL,3,4,-1,AWAY
703,2010,20704,NSH,COL,1,5,-4,AWAY
704,2010,20705,DAL,EDM,2,4,-2,AWAY
705,2010,20706,SJ,VAN,1,2,-1,AWAY
706,2010,20707,PHX,LA,0,2,-2,AWAY
707,2010,20708,NYI,BUF,2,5,-3,AWAY
708,2010,20709,MTL,OTT,1,7,-6,AWAY
709,2010,20710,TB,FLA,1,2,-1,AWAY
710,2010,20711,DAL,CGY,7,4,3,HOME
711,2010,20712,NJ,PHI,1,3,-2,AWAY
712,2010,20713,CHI,DET,1,4,-3,AWAY
713,2010,20714,BOS,COL,2,6,-4,AWAY
714,2010,20715,WSH,TOR,1,4,-3,AWAY
715,2010,20716,ANA,MTL,3,4,-1,AWAY
716,2010,20717,CAR,PIT,3,2,1,HOME
717,2010,20718,NYR,ATL,2,3,-1,AWAY
718,2010,20719,CBJ,STL,2,5,-3,AWAY
719,2010,20720,LA,PHX,3,4,-1,AWAY
720,2010,20721,CGY,VAN,4,5,-1,AWAY
721,2010,20722,MIN,SJ,4,3,1,HOME
722,2010,20723,FLA,NJ,5,2,3,HOME
723,2010,20724,BUF,NYI,3,5,-2,AWAY
724,2010,20725,PHI,CHI,1,4,-3,AWAY
725,2010,20726,ATL,TB,7,1,6,HOME
726,2010,20727,NSH,EDM,2,3,-1,AWAY
727,2010,20728,NYR,WSH,3,4,-1,AWAY
728,2010,20729,TOR,CAR,6,4,2,HOME
729,2010,20730,NSH,CGY,3,1,2,HOME
730,2010,20731,STL,COL,4,3,1,HOME
731,2010,20732,DAL,VAN,7,1,6,HOME
732,2010,20733,BOS,LA,2,0,2,HOME
733,2010,20734,FLA,NYR,3,4,-1,AWAY
734,2010,20735,MTL,PHI,5,2,3,HOME
735,2010,20736,NYI,PIT,1,0,1,HOME
736,2010,20737,ANA,CBJ,2,3,-1,AWAY
737,2010,20738,BUF,OTT,2,3,-1,AWAY
738,2010,20739,TOR,TB,2,0,2,HOME
739,2010,20740,MIN,CHI,2,4,-2,AWAY
740,2010,20741,EDM,PHX,3,4,-1,AWAY
741,2010,20742,FLA,BOS,2,1,1,HOME
742,2010,20743,CAR,NYI,2,4,-2,AWAY
743,2010,20744,WSH,ATL,1,0,1,HOME
744,2010,20745,NJ,DET,3,1,2,HOME
745,2010,20746,EDM,DAL,3,1,2,HOME
746,2010,20747,PHX,COL,2,5,-3,AWAY
747,2010,20748,STL,CGY,4,1,3,HOME
748,2010,20749,NSH,VAN,2,1,1,HOME
749,2010,20750,SJ,LA,3,2,1,HOME
750,2010,20751,FLA,TOR,5,4,1,HOME
751,2010,20752,OTT,NJ,2,1,1,HOME
752,2010,20753,PIT,NYR,3,4,-1,AWAY
753,2010,20754,MTL,WSH,2,3,-1,AWAY
754,2010,20755,BOS,CAR,2,3,-1,AWAY
755,2010,20756,NYI,ATL,1,4,-3,AWAY
756,2010,20757,CHI,CBJ,4,7,-3,AWAY
757,2010,20758,PHI,TB,4,0,4,HOME
758,2010,20759,COL,STL,3,4,-1,AWAY
759,2010,20760,CGY,NSH,2,3,-1,AWAY
760,2010,20761,LA,MIN,1,0,1,HOME
761,2010,20762,VAN,DAL,1,4,-3,AWAY
762,2010,20763,PHX,SJ,5,3,2,HOME
763,2010,20764,DET,OTT,5,7,-2,AWAY
764,2010,20765,NYI,PIT,3,0,3,HOME
765,2010,20766,FLA,MTL,3,2,1,HOME
766,2010,20767,VAN,PHX,0,6,-6,AWAY
767,2010,20768,LA,EDM,1,3,-2,AWAY
768,2010,20769,SJ,ANA,3,4,-1,AWAY
769,2010,20770,DAL,BOS,6,3,3,HOME
770,2010,20771,CAR,TOR,3,0,3,HOME
771,2010,20772,NJ,NYR,2,3,-1,AWAY
772,2010,20773,NSH,PHI,3,2,1,HOME
773,2010,20774,CGY,ATL,2,4,-2,AWAY
774,2010,20775,MIN,COL,3,4,-1,AWAY
775,2010,20776,FLA,NJ,3,4,-1,AWAY
776,2010,20777,BUF,PIT,3,2,1,HOME
777,2010,20778,CBJ,DET,0,3,-3,AWAY
778,2010,20779,WSH,TB,2,5,-3,AWAY
779,2010,20780,EDM,STL,5,3,2,HOME
780,2010,20781,CHI,VAN,4,3,1,HOME
781,2010,20782,SJ,BOS,0,2,-2,AWAY
782,2010,20783,NYR,MTL,2,0,2,HOME
783,2010,20784,ANA,COL,0,3,-3,AWAY
784,2010,20785,TOR,BUF,6,2,4,HOME
785,2010,20786,OTT,NYI,5,3,2,HOME
786,2010,20787,DAL,PHI,3,1,2,HOME
787,2010,20788,ATL,CAR,4,3,1,HOME
788,2010,20789,EDM,CBJ,4,3,1,HOME
789,2010,20790,DET,NSH,3,0,3,HOME
790,2010,20791,MIN,PHX,1,0,1,HOME
791,2010,20792,LA,CGY,5,6,-1,AWAY
792,2010,20793,PIT,WSH,3,0,3,HOME
793,2010,20794,NJ,MTL,1,4,-3,AWAY
794,2010,20795,STL,TB,4,3,1,HOME
795,2010,20796,ATL,TOR,5,4,1,HOME
796,2010,20797,NYR,DET,3,2,1,HOME
797,2010,20798,EDM,NSH,0,4,-4,AWAY
798,2010,20799,CHI,CGY,3,1,2,HOME
799,2010,20800,COL,PHX,3,0,3,HOME
800,2010,20801,OTT,VAN,4,2,2,HOME
801,2010,20802,CAR,NJ,3,2,1,HOME
802,2010,20803,TOR,NYI,3,5,-2,AWAY
803,2010,20804,CBJ,PIT,1,4,-3,AWAY
804,2010,20805,SJ,WSH,0,2,-2,AWAY
805,2010,20806,BUF,TB,4,7,-3,AWAY
806,2010,20807,STL,FLA,1,2,-1,AWAY
807,2010,20808,MTL,BOS,8,6,2,HOME
808,2010,20809,NSH,DET,1,4,-3,AWAY
809,2010,20810,SJ,CBJ,2,3,-1,AWAY
810,2010,20811,COL,MIN,3,2,1,HOME
811,2010,20812,PHX,DAL,2,3,-1,AWAY
812,2010,20813,OTT,CGY,5,2,3,HOME
813,2010,20814,CHI,EDM,1,4,-3,AWAY
814,2010,20815,ANA,VAN,3,4,-1,AWAY
815,2010,20816,NJ,TOR,1,2,-1,AWAY
816,2010,20817,CAR,PHI,2,1,1,HOME
817,2010,20818,LA,PIT,2,1,1,HOME
818,2010,20819,NYI,MTL,3,4,-1,AWAY
819,2010,20820,BUF,FLA,2,3,-1,AWAY
820,2010,20821,DET,BOS,1,6,-5,AWAY
821,2010,20822,SJ,NJ,2,1,1,HOME
822,2010,20823,PIT,NYI,9,3,6,HOME
823,2010,20824,COL,CBJ,3,1,2,HOME
824,2010,20825,NYR,ATL,3,2,1,HOME
825,2010,20826,MIN,STL,7,8,-1,AWAY
826,2010,20827,CHI,DAL,6,4,2,HOME
827,2010,20828,ANA,CGY,4,5,-1,AWAY
828,2010,20829,LA,WSH,1,4,-3,AWAY
829,2010,20830,OTT,EDM,3,5,-2,AWAY
830,2010,20831,TOR,MTL,3,0,3,HOME
831,2010,20832,CAR,TB,4,3,1,HOME
832,2010,20833,COL,NSH,5,3,2,HOME
833,2010,20834,CHI,PHX,3,2,1,HOME
834,2010,20835,STL,MIN,3,1,2,HOME
835,2010,20836,CGY,VAN,4,2,2,HOME
836,2010,20837,NYI,BUF,6,7,-1,AWAY
837,2010,20838,PIT,NYR,5,3,2,HOME
838,2010,20839,CBJ,DAL,1,2,-1,AWAY
839,2010,20840,CAR,ATL,2,3,-1,AWAY
840,2010,20841,SJ,FLA,3,2,1,HOME
841,2010,20842,BOS,DET,4,2,2,HOME
842,2010,20843,LA,PHI,0,1,-1,AWAY
843,2010,20844,ANA,EDM,0,4,-4,AWAY
844,2010,20845,VAN,STL,3,2,1,HOME
845,2010,20846,CGY,COL,1,9,-8,AWAY
846,2010,20847,WSH,PHX,3,2,1,HOME
847,2010,20848,TOR,BOS,3,4,-1,AWAY
848,2010,20849,BUF,MTL,5,6,-1,AWAY
849,2010,20850,NYI,OTT,4,5,-1,AWAY
850,2010,20851,PHI,TB,4,5,-1,AWAY
851,2010,20852,SJ,NSH,1,2,-1,AWAY
852,2010,20853,VAN,MIN,1,4,-3,AWAY
853,2010,20854,DAL,EDM,4,1,3,HOME
854,2010,20855,TOR,BUF,1,2,-1,AWAY
855,2010,20856,CAR,NJ,3,2,1,HOME
856,2010,20857,LA,CBJ,3,4,-1,AWAY
857,2010,20858,PHI,FLA,2,4,-2,AWAY
858,2010,20859,MIN,CHI,3,1,2,HOME
859,2010,20860,PIT,COL,2,3,-1,AWAY
860,2010,20861,DAL,CGY,4,2,2,HOME
861,2010,20862,WSH,ANA,6,7,-1,AWAY
862,2010,20863,BOS,NYI,3,6,-3,AWAY
863,2010,20864,LA,NYR,5,4,1,HOME
864,2010,20865,DET,TB,2,6,-4,AWAY
865,2010,20866,VAN,NSH,3,1,2,HOME
866,2010,20867,MTL,EDM,4,1,3,HOME
867,2010,20868,ATL,PHX,4,3,1,HOME
868,2010,20869,WSH,SJ,3,2,1,HOME
869,2010,20870,NYR,NJ,1,0,1,HOME
870,2010,20871,PHI,CAR,3,2,1,HOME
871,2010,20872,STL,BUF,0,3,-3,AWAY
872,2010,20873,BOS,OTT,2,4,-2,AWAY
873,2010,20874,DET,FLA,3,4,-1,AWAY
874,2010,20875,ANA,MIN,5,1,4,HOME
875,2010,20876,CBJ,CHI,3,4,-1,AWAY
876,2010,20877,ATL,EDM,5,3,2,HOME
877,2010,20878,OTT,TOR,0,1,-1,AWAY
878,2010,20879,LA,NYI,3,0,3,HOME
879,2010,20880,NJ,CAR,1,4,-3,AWAY
880,2010,20881,FLA,TB,2,3,-1,AWAY
881,2010,20882,ANA,STL,9,3,6,HOME
882,2010,20883,PHX,NSH,2,3,-1,AWAY
883,2010,20884,DAL,VAN,5,2,3,HOME
884,2010,20885,COL,SJ,4,0,4,HOME
885,2010,20886,WSH,BUF,1,2,-1,AWAY
886,2010,20887,PHI,NYR,2,4,-2,AWAY
887,2010,20888,PIT,CHI,3,2,1,HOME
888,2010,20889,DET,MIN,1,3,-2,AWAY
889,2010,20890,MTL,CGY,4,0,4,HOME
890,2010,20891,FLA,NYI,5,1,4,HOME
891,2010,20892,CHI,STL,3,5,-2,AWAY
892,2010,20893,WSH,PIT,0,1,-1,AWAY
893,2010,20894,NYI,TOR,2,1,1,HOME
894,2010,20895,PHX,PHI,2,3,-1,AWAY
895,2010,20896,NYR,CAR,3,4,-1,AWAY
896,2010,20897,SJ,DET,3,4,-1,AWAY
897,2010,20898,NSH,CBJ,4,0,4,HOME
898,2010,20899,EDM,MIN,4,1,3,HOME
899,2010,20900,NJ,DAL,0,1,-1,AWAY
900,2010,20901,MTL,VAN,2,3,-1,AWAY
901,2010,20902,ATL,BUF,4,1,3,HOME
902,2010,20903,FLA,OTT,5,1,4,HOME
903,2010,20904,SJ,PIT,2,3,-1,AWAY
904,2010,20905,PHX,TB,8,3,5,HOME
905,2010,20906,BOS,CGY,1,3,-2,AWAY
906,2010,20907,EDM,COL,1,5,-4,AWAY
907,2010,20908,LA,ANA,2,3,-1,AWAY
908,2010,20909,NYI,PHI,4,3,1,HOME
909,2010,20910,DAL,DET,1,4,-3,AWAY
910,2010,20911,TOR,MTL,4,5,-1,AWAY
911,2010,20912,CHI,NSH,0,3,-3,AWAY
912,2010,20913,STL,VAN,3,2,1,HOME
913,2010,20914,MIN,LA,4,2,2,HOME
914,2010,20915,NYR,WSH,0,6,-6,AWAY
915,2010,20916,PIT,CAR,4,1,3,HOME
916,2010,20917,PHX,CBJ,5,3,2,HOME
917,2010,20918,OTT,BUF,4,2,2,HOME
918,2010,20919,FLA,ATL,2,3,-1,AWAY
919,2010,20920,NJ,TB,2,1,1,HOME
920,2010,20921,SJ,CGY,3,4,-1,AWAY
921,2010,20922,STL,EDM,0,5,-5,AWAY
922,2010,20923,MIN,ANA,2,3,-1,AWAY
923,2010,20924,NSH,DAL,3,2,1,HOME
924,2010,20925,COL,LA,4,3,1,HOME
925,2010,20926,DET,BUF,2,4,-2,AWAY
926,2010,20927,PIT,TOR,5,6,-1,AWAY
927,2010,20928,CAR,MTL,4,3,1,HOME
928,2010,20929,PHI,OTT,4,1,3,HOME
929,2010,20930,WSH,NYI,2,3,-1,AWAY
930,2010,20931,BOS,VAN,1,3,-2,AWAY
931,2010,20932,TB,NYR,1,2,-1,AWAY
932,2010,20933,CBJ,NSH,3,2,1,HOME
933,2010,20934,TOR,ATL,3,2,1,HOME
934,2010,20935,NJ,FLA,1,2,-1,AWAY
935,2010,20936,PHX,CHI,4,3,1,HOME
936,2010,20937,STL,CGY,1,0,1,HOME
937,2010,20938,BOS,EDM,2,3,-1,AWAY
938,2010,20939,COL,ANA,3,2,1,HOME
939,2010,20940,CHI,MIN,2,4,-2,AWAY
940,2010,20941,DET,LA,4,7,-3,AWAY
941,2010,20942,BUF,NYR,2,3,-1,AWAY
942,2010,20943,NYI,WSH,2,1,1,HOME
943,2010,20944,FLA,CAR,2,1,1,HOME
944,2010,20945,MTL,ATL,1,3,-2,AWAY
945,2010,20946,BOS,OTT,0,1,-1,AWAY
946,2010,20947,CGY,STL,0,6,-6,AWAY
947,2010,20948,NSH,EDM,3,2,1,HOME
948,2010,20949,DAL,PHX,2,3,-1,AWAY
949,2010,20950,CBJ,VAN,4,3,1,HOME
950,2010,20951,COL,SJ,2,1,1,HOME
951,2010,20952,PIT,TOR,3,2,1,HOME
952,2010,20953,TB,NJ,2,1,1,HOME
953,2010,20954,MIN,NYI,4,1,3,HOME
954,2010,20955,CGY,CHI,6,4,2,HOME
955,2010,20956,DET,ANA,2,1,1,HOME
956,2010,20957,TB,BOS,2,1,1,HOME
957,2010,20958,MIN,NYR,1,3,-2,AWAY
958,2010,20959,TOR,PHI,2,3,-1,AWAY
959,2010,20960,STL,WSH,3,2,1,HOME
960,2010,20961,BUF,CAR,3,2,1,HOME
961,2010,20962,OTT,ATL,1,3,-2,AWAY
962,2010,20963,MTL,FLA,0,4,-4,AWAY
963,2010,20964,CBJ,EDM,4,2,2,HOME
964,2010,20965,NSH,VAN,0,3,-3,AWAY
965,2010,20966,PHX,LA,1,0,1,HOME
966,2010,20967,DET,SJ,3,1,2,HOME
967,2010,20968,PIT,NJ,2,1,1,HOME
968,2010,20969,NYR,OTT,1,4,-3,AWAY
969,2010,20970,CAR,CHI,5,2,3,HOME
970,2010,20971,CBJ,CGY,4,3,1,HOME
971,2010,20972,DAL,ANA,4,3,1,HOME
972,2010,20973,STL,NYI,5,2,3,HOME
973,2010,20974,BUF,PHI,3,5,-2,AWAY
974,2010,20975,VAN,LA,1,3,-2,AWAY
975,2010,20976,PIT,BOS,2,3,-1,AWAY
976,2010,20977,CHI,TOR,3,5,-2,AWAY
977,2010,20978,FLA,ATL,4,3,1,HOME
978,2010,20979,MTL,TB,2,4,-2,AWAY
979,2010,20980,DET,PHX,5,4,1,HOME
980,2010,20981,EDM,COL,1,5,-4,AWAY
981,2010,20982,DAL,SJ,2,3,-1,AWAY
982,2010,20983,NJ,NYI,3,4,-1,AWAY
983,2010,20984,PHI,NYR,7,0,7,HOME
984,2010,20985,WSH,FLA,2,3,-1,AWAY
985,2010,20986,BUF,MIN,2,3,-1,AWAY
986,2010,20987,NSH,CGY,3,2,1,HOME
987,2010,20988,VAN,ANA,0,3,-3,AWAY
988,2010,20989,WSH,TB,1,2,-1,AWAY
989,2010,20990,CBJ,STL,7,6,1,HOME
990,2010,20991,DAL,LA,3,4,-1,AWAY
991,2010,20992,OTT,NJ,1,2,-1,AWAY
992,2010,20993,TOR,NYI,4,3,1,HOME
993,2010,20994,EDM,PHI,4,1,3,HOME
994,2010,20995,BUF,PIT,3,1,2,HOME
995,2010,20996,BOS,MTL,4,1,3,HOME
996,2010,20997,CHI,FLA,3,2,1,HOME
997,2010,20998,COL,MIN,5,2,3,HOME
998,2010,20999,VAN,PHX,3,4,-1,AWAY
999,2010,21000,NSH,SJ,3,2,1,HOME
1000,2010,21001,EDM,WSH,5,0,5,HOME
1001,2010,21002,ATL,CAR,2,3,-1,AWAY
1002,2010,21003,LA,DET,1,2,-1,AWAY
1003,2010,21004,STL,CBJ,3,4,-1,AWAY
1004,2010,21005,CHI,TB,4,3,1,HOME
1005,2010,21006,CGY,DAL,4,5,-1,AWAY
1006,2010,21007,NYR,ANA,5,2,3,HOME
1007,2010,21008,BUF,BOS,3,4,-1,AWAY
1008,2010,21009,PHI,TOR,2,3,-1,AWAY
1009,2010,21010,OTT,FLA,1,2,-1,AWAY
1010,2010,21011,MTL,STL,4,1,3,HOME
1011,2010,21012,MIN,NSH,4,0,4,HOME
1012,2010,21013,CGY,PHX,3,0,3,HOME
1013,2010,21014,VAN,SJ,4,5,-1,AWAY
1014,2010,21015,BOS,NYI,4,2,2,HOME
1015,2010,21016,CAR,WSH,2,1,1,HOME
1016,2010,21017,EDM,DET,2,1,1,HOME
1017,2010,21018,LA,CBJ,2,4,-2,AWAY
1018,2010,21019,NJ,ATL,2,3,-1,AWAY
1019,2010,21020,OTT,TB,1,2,-1,AWAY
1020,2010,21021,MIN,DAL,4,0,4,HOME
1021,2010,21022,ANA,COL,2,6,-4,AWAY
1022,2010,21023,MTL,PIT,0,3,-3,AWAY
1023,2010,21024,BUF,TOR,4,3,1,HOME
1024,2010,21025,NYI,NJ,3,2,1,HOME
1025,2010,21026,ATL,PHI,4,5,-1,AWAY
1026,2010,21027,CBJ,CAR,2,3,-1,AWAY
1027,2010,21028,TB,FLA,4,3,1,HOME
1028,2010,21029,DET,STL,3,5,-2,AWAY
1029,2010,21030,COL,NSH,4,2,2,HOME
1030,2010,21031,VAN,CGY,3,4,-1,AWAY
1031,2010,21032,NYR,SJ,3,4,-1,AWAY
1032,2010,21033,EDM,PIT,5,1,4,HOME
1033,2010,21034,CHI,WSH,4,3,1,HOME
1034,2010,21035,LA,DAL,2,3,-1,AWAY
1035,2010,21036,OTT,BUF,6,4,2,HOME
1036,2010,21037,PHX,ANA,2,5,-3,AWAY
1037,2010,21038,TB,TOR,2,6,-4,AWAY
1038,2010,21039,SJ,CHI,6,3,3,HOME
1039,2010,21040,MIN,VAN,4,2,2,HOME
1040,2010,21041,CAR,BUF,0,1,-1,AWAY
1041,2010,21042,ATL,NJ,4,2,2,HOME
1042,2010,21043,NYI,NYR,6,3,3,HOME
1043,2010,21044,BOS,CBJ,2,3,-1,AWAY
1044,2010,21045,WSH,MTL,2,4,-2,AWAY
1045,2010,21046,PIT,OTT,1,5,-4,AWAY
1046,2010,21047,PHI,FLA,2,3,-1,AWAY
1047,2010,21048,LA,NSH,2,4,-2,AWAY
1048,2010,21049,SJ,DAL,3,6,-3,AWAY
1049,2010,21050,PHX,CGY,3,4,-1,AWAY
1050,2010,21051,TOR,CAR,1,3,-2,AWAY
1051,2010,21052,WSH,DET,3,2,1,HOME
1052,2010,21053,COL,VAN,4,2,2,HOME
1053,2010,21054,STL,ANA,2,1,1,HOME
1054,2010,21055,PHI,ATL,5,3,2,HOME
1055,2010,21056,DET,CBJ,0,2,-2,AWAY
1056,2010,21057,TB,MTL,4,3,1,HOME
1057,2010,21058,NJ,OTT,3,1,2,HOME
1058,2010,21059,TOR,FLA,4,0,4,HOME
1059,2010,21060,BOS,NSH,4,3,1,HOME
1060,2010,21061,CHI,DAL,5,0,5,HOME
1061,2010,21062,COL,CGY,5,2,3,HOME
1062,2010,21063,PHX,EDM,1,3,-2,AWAY
1063,2010,21064,STL,LA,0,4,-4,AWAY
1064,2010,21065,MIN,SJ,3,2,1,HOME
1065,2010,21066,WSH,NJ,0,3,-3,AWAY
1066,2010,21067,MTL,NYR,6,3,3,HOME
1067,2010,21068,NYI,CAR,3,2,1,HOME
1068,2010,21069,PHX,VAN,1,3,-2,AWAY
1069,2010,21070,CBJ,MIN,4,5,-1,AWAY
1070,2010,21071,ATL,BUF,8,2,6,HOME
1071,2010,21072,BOS,TOR,5,2,3,HOME
1072,2010,21073,TB,OTT,3,2,1,HOME
1073,2010,21074,NYI,FLA,3,5,-2,AWAY
1074,2010,21075,DET,NSH,3,1,2,HOME
1075,2010,21076,PHI,DAL,3,4,-1,AWAY
1076,2010,21077,COL,EDM,2,3,-1,AWAY
1077,2010,21078,ANA,LA,1,2,-1,AWAY
1078,2010,21079,STL,SJ,5,3,2,HOME
1079,2010,21080,NYR,PIT,2,5,-3,AWAY
1080,2010,21081,NSH,BUF,3,4,-1,AWAY
1081,2010,21082,NJ,CBJ,0,3,-3,AWAY
1082,2010,21083,MTL,MIN,1,8,-7,AWAY
1083,2010,21084,CHI,PHX,1,2,-1,AWAY
1084,2010,21085,CGY,ANA,5,4,1,HOME
1085,2010,21086,PIT,DET,4,5,-1,AWAY
1086,2010,21087,CGY,LA,3,2,1,HOME
1087,2010,21088,NJ,BOS,4,1,3,HOME
1088,2010,21089,FLA,NYR,1,0,1,HOME
1089,2010,21090,WSH,PHI,6,7,-1,AWAY
1090,2010,21091,OTT,CAR,4,3,1,HOME
1091,2010,21092,BUF,MTL,0,2,-2,AWAY
1092,2010,21093,NYI,TB,2,5,-3,AWAY
1093,2010,21094,EDM,NSH,3,1,2,HOME
1094,2010,21095,TOR,MIN,0,3,-3,AWAY
1095,2010,21096,CBJ,COL,5,4,1,HOME
1096,2010,21097,STL,PHX,2,1,1,HOME
1097,2010,21098,VAN,DET,1,2,-1,AWAY
1098,2010,21099,FLA,CHI,4,0,4,HOME
1099,2010,21100,ANA,DAL,3,4,-1,AWAY
1100,2010,21101,CGY,SJ,6,3,3,HOME
1101,2010,21102,MTL,BOS,7,0,7,HOME
1102,2010,21103,ATL,NYI,1,2,-1,AWAY
1103,2010,21104,OTT,NYR,1,2,-1,AWAY
1104,2010,21105,PIT,PHI,2,3,-1,AWAY
1105,2010,21106,EDM,STL,4,0,4,HOME
1106,2010,21107,ANA,NSH,5,4,1,HOME
1107,2010,21108,TOR,COL,3,4,-1,AWAY
1108,2010,21109,CBJ,PHX,3,0,3,HOME
1109,2010,21110,SJ,LA,5,4,1,HOME
1110,2010,21111,NJ,PIT,1,0,1,HOME
1111,2010,21112,FLA,BUF,4,2,2,HOME
1112,2010,21113,WSH,OTT,2,0,2,HOME
1113,2010,21114,VAN,ATL,1,3,-2,AWAY
1114,2010,21115,CAR,TB,3,4,-1,AWAY
1115,2010,21116,NYR,BOS,0,1,-1,AWAY
1116,2010,21117,COL,LA,4,1,3,HOME
1117,2010,21118,NJ,BUF,2,0,2,HOME
1118,2010,21119,WSH,MTL,0,2,-2,AWAY
1119,2010,21120,PHI,NYI,1,4,-3,AWAY
1120,2010,21121,TB,CAR,2,4,-2,AWAY
1121,2010,21122,TOR,DET,4,2,2,HOME
1122,2010,21123,DAL,NSH,4,2,2,HOME
1123,2010,21124,STL,MIN,3,6,-3,AWAY
1124,2010,21125,ANA,CHI,1,2,-1,AWAY
1125,2010,21126,SJ,PHX,1,4,-3,AWAY
1126,2010,21127,CGY,EDM,4,5,-1,AWAY
1127,2010,21128,FLA,PIT,3,1,2,HOME
1128,2010,21129,OTT,ATL,5,4,1,HOME
1129,2010,21130,VAN,CBJ,1,4,-3,AWAY
1130,2010,21131,BOS,PHI,1,2,-1,AWAY
1131,2010,21132,CHI,DET,2,3,-1,AWAY
1132,2010,21133,COL,ANA,5,4,1,HOME
1133,2010,21134,CHI,BOS,3,0,3,HOME
1134,2010,21135,BUF,TOR,4,3,1,HOME
1135,2010,21136,PHI,PIT,2,5,-3,AWAY
1136,2010,21137,CAR,WSH,2,4,-2,AWAY
1137,2010,21138,FLA,CBJ,3,2,1,HOME
1138,2010,21139,ATL,MTL,3,1,2,HOME
1139,2010,21140,OTT,TB,5,2,3,HOME
1140,2010,21141,MIN,STL,3,4,-1,AWAY
1141,2010,21142,VAN,NSH,1,3,-2,AWAY
1142,2010,21143,LA,EDM,0,2,-2,AWAY
1143,2010,21144,DAL,PHX,3,2,1,HOME
1144,2010,21145,NYR,BUF,1,0,1,HOME
1145,2010,21146,NYI,NJ,3,2,1,HOME
1146,2010,21147,MTL,CAR,6,2,4,HOME
1147,2010,21148,STL,DET,3,10,-7,AWAY
1148,2010,21149,ANA,CGY,2,4,-2,AWAY
1149,2010,21150,TOR,BOS,3,4,-1,AWAY
1150,2010,21151,NYR,NYI,6,2,4,HOME
1151,2010,21152,ATL,PHI,0,1,-1,AWAY
1152,2010,21153,CBJ,WSH,4,3,1,HOME
1153,2010,21154,PIT,TB,2,1,1,HOME
1154,2010,21155,OTT,FLA,1,4,-3,AWAY
1155,2010,21156,EDM,MIN,4,2,2,HOME
1156,2010,21157,NSH,COL,2,3,-1,AWAY
1157,2010,21158,LA,VAN,3,1,2,HOME
1158,2010,21159,DAL,SJ,6,0,6,HOME
1159,2010,21160,PHI,NJ,4,2,2,HOME
1160,2010,21161,CHI,CBJ,3,4,-1,AWAY
1161,2010,21162,CGY,STL,2,3,-1,AWAY
1162,2010,21163,COL,PHX,3,4,-1,AWAY
1163,2010,21164,ATL,BOS,3,2,1,HOME
1164,2010,21165,TB,MIN,1,3,-2,AWAY
1165,2010,21166,DET,NSH,3,4,-1,AWAY
1166,2010,21167,DAL,LA,3,1,2,HOME
1167,2010,21168,TOR,OTT,2,4,-2,AWAY
1168,2010,21169,MTL,NJ,1,3,-2,AWAY
1169,2010,21170,CAR,NYI,2,4,-2,AWAY
1170,2010,21171,BUF,WSH,5,4,1,HOME
1171,2010,21172,PIT,FLA,2,4,-2,AWAY
1172,2010,21173,EDM,VAN,1,4,-3,AWAY
1173,2010,21174,ANA,SJ,4,2,2,HOME
1174,2010,21175,NYR,PHI,2,4,-2,AWAY
1175,2010,21176,BUF,CAR,1,2,-1,AWAY
1176,2010,21177,MIN,DET,4,2,2,HOME
1177,2010,21178,STL,CBJ,1,6,-5,AWAY
1178,2010,21179,TB,CHI,0,2,-2,AWAY
1179,2010,21180,CGY,COL,1,2,-1,AWAY
1180,2010,21181,DAL,ANA,3,4,-1,AWAY
1181,2010,21182,BOS,NYR,5,3,2,HOME
1182,2010,21183,LA,SJ,6,1,5,HOME
1183,2010,21184,TB,BUF,4,2,2,HOME
1184,2010,21185,WSH,TOR,2,3,-1,AWAY
1185,2010,21186,NJ,PIT,4,2,2,HOME
1186,2010,21187,CHI,MTL,2,1,1,HOME
1187,2010,21188,PHI,OTT,5,2,3,HOME
1188,2010,21189,COL,STL,3,1,2,HOME
1189,2010,21190,ATL,NSH,6,3,3,HOME
1190,2010,21191,CBJ,DAL,3,0,3,HOME
1191,2010,21192,VAN,EDM,2,0,2,HOME
1192,2010,21193,NYI,BOS,3,2,1,HOME
1193,2010,21194,TOR,NJ,4,2,2,HOME
1194,2010,21195,FLA,WSH,5,2,3,HOME
1195,2010,21196,DET,CAR,3,0,3,HOME
1196,2010,21197,STL,CHI,4,3,1,HOME
1197,2010,21198,EDM,CGY,6,1,5,HOME
1198,2010,21199,SJ,ANA,6,2,4,HOME
1199,2010,21200,PHX,LA,4,3,1,HOME
1200,2010,21201,ATL,NYR,0,3,-3,AWAY
1201,2010,21202,MTL,OTT,3,2,1,HOME
1202,2010,21203,COL,DAL,4,2,2,HOME
1203,2010,21204,MIN,VAN,5,0,5,HOME
1204,2010,21205,PIT,NYI,3,4,-1,AWAY
1205,2010,21206,CHI,DET,2,4,-2,AWAY
1206,2010,21207,PHI,BUF,4,3,1,HOME
1207,2010,21208,CAR,ATL,1,6,-5,AWAY
1208,2010,21209,FLA,TB,4,2,2,HOME
1209,2010,21210,CBJ,NSH,4,1,3,HOME
1210,2010,21211,DAL,COL,2,3,-1,AWAY
1211,2010,21212,MIN,EDM,1,3,-2,AWAY
1212,2010,21213,SJ,PHX,4,3,1,HOME
1213,2010,21214,LA,ANA,2,1,1,HOME
1214,2010,21215,NJ,NYR,5,2,3,HOME
1215,2010,21216,OTT,BOS,3,1,2,HOME
1216,2010,21217,MTL,TOR,1,4,-3,AWAY
1217,2010,21218,NYI,PHI,7,4,3,HOME
1218,2010,21219,TB,CAR,2,6,-4,AWAY
1219,2010,21220,WSH,FLA,1,0,1,HOME
1220,2010,21221,BUF,CBJ,4,5,-1,AWAY
1221,2010,21222,NSH,STL,2,0,2,HOME
1222,2010,21223,VAN,CGY,2,3,-1,AWAY
1223,2010,21224,ANA,LA,1,3,-2,AWAY
1224,2010,21225,PHX,SJ,3,1,2,HOME
1225,2010,21226,BOS,NJ,3,2,1,HOME
1226,2010,21227,PIT,ATL,2,5,-3,AWAY
1227,2010,21228,EDM,COL,4,3,1,HOME
1228,2010,21229,DET,CHI,3,4,-1,AWAY
1229,2010,21230,DAL,MIN,5,3,2,HOME
1230,2010,30111,NYR,WSH,2,1,1,HOME
1231,2010,30112,NYR,WSH,2,0,2,HOME
1232,2010,30113,WSH,NYR,3,2,1,HOME
1233,2010,30114,WSH,NYR,3,4,-1,AWAY
1234,2010,30115,NYR,WSH,3,1,2,HOME
1235,2010,30121,BUF,PHI,0,1,-1,AWAY
1236,2010,30122,BUF,PHI,5,4,1,HOME
1237,2010,30123,PHI,BUF,2,4,-2,AWAY
1238,2010,30124,PHI,BUF,1,0,1,HOME
1239,2010,30125,BUF,PHI,3,4,-1,AWAY
1240,2010,30126,PHI,BUF,4,5,-1,AWAY
1241,2010,30127,BUF,PHI,5,2,3,HOME
1242,2010,30131,MTL,BOS,0,2,-2,AWAY
1243,2010,30132,MTL,BOS,1,3,-2,AWAY
1244,2010,30133,BOS,MTL,2,4,-2,AWAY
1245,2010,30134,BOS,MTL,4,5,-1,AWAY
1246,2010,30135,MTL,BOS,2,1,1,HOME
1247,2010,30136,BOS,MTL,2,1,1,HOME
1248,2010,30137,MTL,BOS,4,3,1,HOME
1249,2010,30141,TB,PIT,3,0,3,HOME
1250,2010,30142,TB,PIT,1,5,-4,AWAY
1251,2010,30143,PIT,TB,2,3,-1,AWAY
1252,2010,30144,PIT,TB,2,3,-1,AWAY
1253,2010,30145,TB,PIT,2,8,-6,AWAY
1254,2010,30146,PIT,TB,4,2,2,HOME
1255,2010,30147,TB,PIT,0,1,-1,AWAY
1256,2010,30151,CHI,VAN,2,0,2,HOME
1257,2010,30152,CHI,VAN,4,3,1,HOME
1258,2010,30153,VAN,CHI,2,3,-1,AWAY
1259,2010,30154,VAN,CHI,7,2,5,HOME
1260,2010,30155,CHI,VAN,0,5,-5,AWAY
1261,2010,30156,VAN,CHI,4,3,1,HOME
1262,2010,30157,CHI,VAN,2,1,1,HOME
1263,2010,30161,LA,SJ,3,2,1,HOME
1264,2010,30162,LA,SJ,0,4,-4,AWAY
1265,2010,30163,SJ,LA,5,6,-1,AWAY
1266,2010,30164,SJ,LA,3,6,-3,AWAY
1267,2010,30165,LA,SJ,1,3,-2,AWAY
1268,2010,30166,SJ,LA,3,4,-1,AWAY
1269,2010,30171,PHX,DET,4,2,2,HOME
1270,2010,30172,PHX,DET,4,3,1,HOME
1271,2010,30173,DET,PHX,2,4,-2,AWAY
1272,2010,30174,DET,PHX,3,6,-3,AWAY
1273,2010,30181,NSH,ANA,1,4,-3,AWAY
1274,2010,30182,NSH,ANA,5,3,2,HOME
1275,2010,30183,ANA,NSH,4,3,1,HOME
1276,2010,30184,ANA,NSH,3,6,-3,AWAY
1277,2010,30185,NSH,ANA,3,4,-1,AWAY
1278,2010,30186,ANA,NSH,4,2,2,HOME
1279,2010,30211,TB,WSH,2,4,-2,AWAY
1280,2010,30212,TB,WSH,2,3,-1,AWAY
1281,2010,30213,WSH,TB,4,3,1,HOME
1282,2010,30214,WSH,TB,5,3,2,HOME
1283,2010,30221,BOS,PHI,3,7,-4,AWAY
1284,2010,30222,BOS,PHI,2,3,-1,AWAY
1285,2010,30223,PHI,BOS,5,1,4,HOME
1286,2010,30224,PHI,BOS,5,1,4,HOME
1287,2010,30231,NSH,VAN,1,0,1,HOME
1288,2010,30232,NSH,VAN,1,2,-1,AWAY
1289,2010,30233,VAN,NSH,2,3,-1,AWAY
1290,2010,30234,VAN,NSH,2,4,-2,AWAY
1291,2010,30236,VAN,NSH,1,2,-1,AWAY
1292,2010,30241,DET,SJ,2,1,1,HOME
1293,2010,30242,DET,SJ,2,1,1,HOME
1294,2010,30243,SJ,DET,3,4,-1,AWAY
1295,2010,30244,SJ,DET,4,3,1,HOME
1296,2010,30246,SJ,DET,3,1,2,HOME
1297,2010,30247,DET,SJ,3,2,1,HOME
1298,2010,30311,TB,BOS,2,5,-3,AWAY
1299,2010,30312,TB,BOS,6,5,1,HOME
1300,2010,30313,BOS,TB,0,2,-2,AWAY
1301,2010,30314,BOS,TB,5,3,2,HOME
1302,2010,30315,TB,BOS,3,1,2,HOME
1303,2010,30316,BOS,TB,5,4,1,HOME
1304,2010,30321,SJ,VAN,3,2,1,HOME
1305,2010,30322,SJ,VAN,7,3,4,HOME
1306,2010,30323,VAN,SJ,4,3,1,HOME
1307,2010,30324,VAN,SJ,2,4,-2,AWAY
1308,2010,30325,SJ,VAN,3,2,1,HOME
1309,2010,30411,BOS,VAN,1,0,1,HOME
1310,2010,30412,BOS,VAN,3,2,1,HOME
1311,2010,30413,VAN,BOS,8,1,7,HOME
1312,2010,30414,VAN,BOS,4,0,4,HOME
1313,2010,30415,BOS,VAN,1,0,1,HOME
1314,2010,30416,VAN,BOS,5,2,3,HOME
1315,2010,30417,BOS,VAN,0,4,-4,AWAY
